11,11,11,11,11,11,11,11,11,11,11,11,11,11,11,11
11,11,11,11,11,11,11,11,11,11,11,11,11,11,11,11
11,11,11,11,11,11,11,11,11,11,11,11,11,11,11,11
11,11,11,11,11,11,11,11,11,11,11,11,11,11,11,11
11,11,11,11,12,12,12,1,11,11,11,11,11,11,11,11
11,11,11,11,1,1,2,1,11,11,14,14,14,14,16,14
11,11,11,11,1,1,2,1,11,11,14,14,14,14,16,14
11,11,11,11,1,1,2,1,11,11,14,14,14,14,16,14
11,11,11,11,1,1,2,1,11,11,14,14,14,14,16,14
11,11,11,11,11,11,11,11,11,11,14,14,14,14,16,14
11,11,11,11,11,11,11,11,11,11,14,14,14,14,16,14
11,11,11,11,11,11,11,11,11,11,14,14,14,14,16,14
